SO textures/south.xpm
NO textures/north.xpm
WE textures/west.xpm
EA textures/east.xpm
S textures/monster.xpm


F 80, 80, 80

C 77, 143, 172

R    1600     900

        1111111111111111111111111
        1000000000110000000000001
        1011000001110000000000001
        1001000000000000000000001
111111111011000001110000000000001
111000000011000001110111111111111
  110111111111011100000012221
11100111111111011101010012221
11000000110101011100000010001
100000000000000000000000000011
10000000000000001101010010N001
110000011101010111110111100011
11101111 11101111011110100011
11111111 111111 111111111111
