

SO textures/south.xpm
NO textures/north.xpm
WE textures/west.xpm
EA textures/east.xpm
S textures/monster.xpm



F 255,255,255
C 255,0,255
R    900     900

1111111
10E101
1111111
